aqqqqqqqqqqqqqqqqqqqqqqqqqqqqa
a  gggggagggggggggggagggggggga
a   b   ab    b   a  b     b a
a       a      a       a     a
a    b  a    bg   b      b   a
ag  b   ab   a       b       a
ab      a  b  b        b    ga
a  b    ga      g  b a      ba
a       b            a       a
a    b      b    b   ab   aaaa
aa            b     aa       a
a   b    s        s  a b     a
a        a    a   a  a     bba
assssssssssssssssssssasssbbbea
aqqqqqqqqqqqqqqqqqqqqqqqqqqqqa
