wwwwwwwwwwwwwwwwwwwwwwwwwwwwww
w  gg           www    b     w
w  www                 ww    w
w                      ww    w
w                            w
w                            w
w                            w
w                            w
w                            w
w                            w
w wwww                 ww    w
w wwww                 ww    w
wswwwwssssssssssssssssswwssssw
wwwwwwwwwwwwwwwwwwwwwwwwwwwwww
